
Rk,Player,Age,G,GS,MP,FG,FGA,FG%,3P,3PA,3P%,2P,2PA,2P%,eFG%,FT,FTA,FT%,ORB,DRB,TRB,AST,STL,BLK,TOV,PF,PTS
1,Victor Oladipo,22,72,71,2573,473,1086,.436,84,248,.339,389,838,.464,.474,262,320,.819,51,251,302,295,120,19,204,187,1292
2,Nikola Vucevic,24,74,74,2529,631,1206,.523,2,6,.333,629,1200,.524,.524,164,218,.752,238,572,810,147,54,54,148,220,1428
3,Elfrid Payton,20,82,63,2489,301,708,.425,11,42,.262,290,666,.435,.433,118,214,.551,107,242,349,533,142,20,203,193,731
4,Tobias Harris,22,68,63,2369,442,949,.466,87,239,.364,355,710,.500,.512,193,245,.788,73,357,430,124,69,36,115,134,1164
5,Channing Frye,31,75,51,1870,191,487,.392,136,346,.393,55,141,.390,.532,31,35,.886,27,266,293,94,47,39,78,191,549
6,Evan Fournier,22,58,32,1661,253,575,.440,85,225,.378,168,350,.480,.514,107,147,.728,28,125,153,120,40,2,82,116,698
7,Willie Green,33,52,2,951,118,306,.386,42,121,.347,76,185,.411,.454,28,34,.824,14,65,79,68,26,5,48,81,306
8,Dewayne Dedmon,25,59,15,845,91,162,.562,0,1,.000,91,161,.565,.562,34,64,.531,118,177,295,9,16,50,51,141,216
9,Kyle O'Quinn,24,51,17,824,119,242,.492,12,43,.279,107,199,.538,.517,44,57,.772,46,153,199,59,31,39,55,110,294
10,Aaron Gordon,19,47,8,797,93,208,.447,13,48,.271,80,160,.500,.478,44,61,.721,46,123,169,33,21,22,38,83,243
11,Ben Gordon,31,56,0,790,129,295,.437,35,97,.361,94,198,.475,.497,56,67,.836,6,57,63,50,14,1,55,60,349
12,Luke Ridnour,33,47,0,683,75,176,.426,20,63,.317,55,113,.487,.483,18,21,.857,8,60,68,96,20,4,38,67,188
13,Maurice Harkless,21,45,4,674,63,158,.399,10,56,.179,53,102,.520,.430,22,41,.537,38,68,106,25,32,9,27,66,158
14,Andrew Nicholson,25,40,3,492,83,190,.437,13,41,.317,70,149,.470,.471,15,25,.600,17,65,82,22,6,12,24,51,194
15,Devyn Marble,22,16,7,208,14,44,.318,4,22,.182,10,22,.455,.364,5,16,.313,5,26,31,17,9,2,9,14,37
,Team Totals,,82,,19755,3076,6792,.453,554,1598,.347,2522,5194,.486,.494,1141,1565,.729,822,2607,3429,1692,647,314,1221,1714,7847