
Rk,Player,Age,G,GS,MP,FG,FGA,FG%,3P,3PA,3P%,2P,2PA,2P%,eFG%,FT,FTA,FT%,ORB,DRB,TRB,AST,STL,BLK,TOV,PF,PTS
1,John Wall,23,82,82,2980,579,1337,.433,108,308,.351,471,1029,.458,.473,317,394,.805,38,295,333,721,149,40,295,219,1583
2,Trevor Ariza,28,77,77,2723,389,853,.456,180,442,.407,209,411,.509,.562,149,193,.772,99,376,475,191,126,20,132,179,1107
3,Marcin Gortat,29,81,80,2655,455,840,.542,1,1,1.000,454,839,.541,.542,157,229,.686,202,565,767,138,41,121,126,201,1068
4,Bradley Beal,20,73,73,2530,481,1149,.419,138,343,.402,343,806,.426,.479,149,189,.788,54,219,273,243,71,18,128,153,1249
5,Martell Webster,27,78,13,2157,254,587,.433,146,372,.392,108,215,.502,.557,105,125,.840,38,184,222,97,41,15,58,150,759
6,Nene Hilario,31,53,37,1560,299,594,.503,1,5,.200,298,589,.506,.504,155,266,.583,65,229,294,153,64,47,117,164,754
7,Trevor Booker,26,72,45,1553,222,403,.551,0,2,.000,222,401,.554,.551,47,76,.618,149,230,379,64,41,45,58,131,491
8,Garrett Temple,27,75,0,638,51,141,.362,6,29,.207,45,112,.402,.383,30,43,.698,21,47,68,72,35,11,42,72,138
9,Kevin Seraphin,24,53,1,578,111,220,.505,0,0,,111,220,.505,.505,27,31,.871,53,75,128,17,3,26,41,103,249
10,Al Harrington,33,34,0,511,82,207,.396,34,100,.340,48,107,.449,.478,27,35,.771,15,65,80,28,14,0,34,72,225
11,Jan Vesely,23,33,1,470,48,92,.522,0,0,,48,92,.522,.522,8,30,.267,53,60,113,10,26,19,22,64,104
12,Andre Miller,37,28,0,412,40,87,.460,2,3,.667,38,84,.452,.471,25,30,.833,12,45,57,97,19,2,28,43,107
13,Drew Gooden,32,22,0,395,76,143,.531,7,17,.412,69,126,.548,.556,24,27,.889,37,77,114,15,10,7,17,53,183
14,Otto Porter,20,37,0,319,33,91,.363,4,21,.190,29,70,.414,.385,8,12,.667,21,36,57,10,8,1,14,26,78
15,Chris Singleton,24,25,0,250,25,67,.373,7,19,.368,18,48,.375,.425,18,25,.720,18,37,55,6,9,3,17,25,75
16,Eric Maynor,26,23,0,215,21,72,.292,8,25,.320,13,47,.277,.347,2,3,.667,7,17,24,40,5,1,17,13,52
17,Glen Rice,23,11,1,109,11,37,.297,5,17,.294,6,20,.300,.365,5,7,.714,4,16,20,7,6,1,9,7,32
,Team Totals,,82,,20055,3177,6920,.459,647,1704,.380,2530,5216,.485,.506,1253,1715,.731,886,2573,3459,1909,668,377,1204,1675,8254