
Rk,Player,Age,G,GS,MP,FG,FGA,FG%,3P,3PA,3P%,2P,2PA,2P%,eFG%,FT,FTA,FT%,ORB,DRB,TRB,AST,STL,BLK,TOV,PF,PTS
1,Danny Granger,27,79,79,2763,535,1260,.425,157,407,.386,378,853,.443,.487,395,466,.848,87,338,425,203,89,62,206,213,1622
2,Darren Collison,23,79,79,2360,398,870,.457,41,124,.331,357,746,.479,.481,202,232,.871,40,185,225,403,87,14,194,109,1039
3,Roy Hibbert,24,81,80,2244,410,890,.461,0,4,.000,410,886,.463,.461,205,275,.745,182,428,610,166,33,142,185,256,1025
4,Brandon Rush,25,67,21,1754,217,515,.421,93,223,.417,124,292,.425,.512,80,106,.755,33,184,217,62,41,35,69,107,607
5,Mike Dunleavy,30,61,44,1683,240,520,.462,102,254,.402,138,266,.519,.560,100,125,.800,28,248,276,105,40,30,69,107,682
6,Josh McRoberts,23,72,51,1597,211,386,.547,23,60,.383,188,326,.577,.576,88,119,.739,109,273,382,150,47,57,93,165,533
7,Tyler Hansbrough,25,70,29,1535,285,613,.465,0,2,.000,285,611,.466,.465,197,253,.779,145,221,366,41,37,15,76,160,767
8,Paul George,20,61,19,1265,179,395,.453,41,138,.297,138,257,.537,.505,77,101,.762,37,187,224,65,62,26,70,127,476
9,Jeff Foster,34,56,3,940,80,167,.479,0,3,.000,80,164,.488,.479,27,48,.563,160,190,350,46,24,31,26,127,187
10,James Posey,34,49,0,839,81,241,.336,67,212,.316,14,29,.483,.475,11,15,.733,10,137,147,34,24,6,24,103,240
11,A.J. Price,24,50,0,795,114,320,.356,41,149,.275,73,171,.427,.420,54,81,.667,16,56,72,111,29,1,53,61,323
12,T.J. Ford,27,41,3,773,91,236,.386,6,32,.188,85,204,.417,.398,35,48,.729,17,64,81,141,35,8,63,69,223
13,Dahntay Jones,30,45,2,589,100,214,.467,14,39,.359,86,175,.491,.500,69,90,.767,4,61,65,33,20,7,31,70,283
14,Solomon Jones,26,39,0,528,49,121,.405,0,1,.000,49,120,.408,.405,41,62,.661,45,68,113,30,12,22,35,94,139
15,Lance Stephenson,20,12,0,115,13,39,.333,0,5,.000,13,34,.382,.333,11,14,.786,1,17,18,21,4,0,16,14,37
,Team Totals,,82,,19780,3003,6787,.442,585,1653,.354,2418,5134,.471,.486,1592,2035,.782,914,2657,3571,1611,584,456,1262,1782,8183